15 32
218 15 0 196 15 0 196 15 0 196 15 0 196 15 0 196 15 0 196 15 0 196 15 0 196 15 0 196 15 0 196 15 0 196 15 0 196 15 0 196 15 0 196 15 0 196 15 0 196 15 0 196 15 0 196 15 0 196 15 0 196 15 0 196 15 0 196 15 0 196 15 0 196 15 0 196 15 0 196 15 0 196 15 0 196 15 0 196 15 0 196 15 0 191 15 0 
179 15 0 32 15 0 32 15 0 32 15 0 32 15 0 32 15 0 32 15 0 32 15 0 32 15 0 32 15 0 32 15 0 32 15 0 32 15 0 32 15 0 32 15 0 32 15 0 32 15 0 32 15 0 32 15 0 32 15 0 32 15 0 32 15 0 32 15 0 32 15 0 32 15 0 32 15 0 32 15 0 32 15 0 32 15 0 32 15 0 32 15 0 179 15 0 
179 15 0 58 0 0 78 4 0 85 4 0 77 12 0 66 2 0 69 3 0 82 4 0 58 0 0 79 6 0 70 9 0 58 0 0 77 4 0 79 10 0 86 9 0 69 2 0 83 4 0 58 15 0 32 15 0 32 15 0 32 15 0 32 15 0 32 15 0 32 15 0 32 15 0 32 15 0 32 15 0 32 15 0 32 15 0 32 15 0 32 15 0 179 15 0 
179 15 0 32 15 0 32 15 0 32 15 0 32 15 0 32 15 0 32 15 0 32 15 0 32 15 0 32 15 0 32 15 0 32 15 0 32 15 0 32 15 0 32 15 0 32 15 0 32 15 0 32 15 0 32 15 0 32 15 0 32 15 0 32 15 0 32 15 0 32 15 0 32 15 0 32 15 0 32 15 0 32 15 0 32 15 0 32 15 0 32 15 0 179 15 0 
179 15 0 32 15 0 32 15 0 32 15 0 32 15 0 32 15 0 32 15 0 32 15 0 32 15 0 32 15 0 32 15 0 32 15 0 32 15 0 32 15 0 32 15 0 32 15 0 32 15 0 32 15 0 32 15 0 32 15 0 32 15 0 32 15 0 32 15 0 32 15 0 32 15 0 32 15 0 32 15 0 32 15 0 32 15 0 32 15 0 32 15 0 179 15 0 
179 15 0 32 15 0 83 4 0 67 4 0 79 4 0 82 4 0 73 4 0 78 4 0 71 4 0 58 4 0 32 15 0 32 15 0 32 15 0 32 15 0 32 15 0 32 15 0 32 15 0 32 15 0 32 15 0 32 15 0 32 15 0 32 15 0 32 15 0 32 15 0 32 15 0 32 15 0 32 15 0 32 15 0 32 15 0 32 15 0 32 15 0 179 15 0 
179 15 0 32 15 0 32 15 0 32 15 0 32 15 0 32 15 0 32 15 0 32 15 0 32 15 0 32 15 0 32 15 0 32 15 0 32 15 0 32 15 0 32 15 0 32 15 0 32 15 0 32 15 0 32 15 0 32 15 0 32 15 0 32 15 0 32 15 0 32 15 0 32 15 0 32 15 0 32 15 0 32 15 0 32 15 0 32 15 0 32 15 0 179 15 0 
179 15 0 32 15 0 32 15 0 32 15 0 32 15 0 71 2 0 82 2 0 69 2 0 65 2 0 84 2 0 33 2 0 32 15 0 32 15 0 49 2 0 50 2 0 45 2 0 49 2 0 56 2 0 32 15 0 77 2 0 79 2 0 86 2 0 69 2 0 83 2 0 32 15 0 32 15 0 32 15 0 32 15 0 32 15 0 32 15 0 32 15 0 179 15 0 
179 15 0 32 15 0 32 15 0 32 15 0 32 15 0 32 15 0 32 15 0 32 15 0 32 15 0 32 15 0 32 15 0 32 15 0 32 15 0 32 15 0 32 15 0 32 15 0 32 15 0 32 15 0 32 15 0 32 15 0 32 15 0 32 15 0 32 15 0 32 15 0 32 15 0 32 15 0 32 15 0 32 15 0 32 15 0 32 15 0 32 15 0 179 15 0 
179 15 0 32 15 0 32 15 0 32 15 0 32 15 0 71 9 0 79 9 0 79 9 0 68 9 0 33 9 0 32 15 0 32 15 0 32 15 0 49 9 0 56 9 0 45 9 0 50 9 0 52 9 0 32 15 0 77 9 0 79 9 0 86 9 0 69 9 0 83 9 0 32 15 0 32 15 0 32 15 0 32 15 0 32 15 0 32 15 0 32 15 0 179 15 0 
179 15 0 32 15 0 32 15 0 32 15 0 32 15 0 32 15 0 32 15 0 32 15 0 32 15 0 32 15 0 32 15 0 32 15 0 32 15 0 32 15 0 32 15 0 32 15 0 32 15 0 32 15 0 32 15 0 32 15 0 32 15 0 32 15 0 32 15 0 32 15 0 32 15 0 32 15 0 32 15 0 32 15 0 32 15 0 32 15 0 32 15 0 179 15 0 
179 15 0 32 15 0 32 15 0 32 15 0 32 15 0 77 6 0 69 6 0 72 6 0 46 6 0 46 6 0 46 6 0 32 15 0 32 15 0 50 6 0 52 6 0 45 6 0 51 6 0 54 6 0 32 15 0 77 6 0 79 6 0 86 6 0 69 6 0 83 6 0 32 15 0 32 15 0 32 15 0 32 15 0 32 15 0 32 15 0 32 15 0 179 15 0 
179 15 0 32 15 0 32 15 0 32 15 0 32 15 0 33 0 0 32 15 0 32 15 0 32 15 0 32 15 0 32 15 0 32 15 0 32 15 0 32 15 0 32 15 0 32 15 0 32 15 0 32 15 0 32 15 0 32 15 0 32 15 0 32 15 0 32 15 0 32 15 0 32 15 0 32 15 0 32 15 0 32 15 0 32 15 0 32 15 0 32 15 0 179 15 0 
179 15 0 32 15 0 32 15 0 32 15 0 32 15 0 89 12 0 73 12 0 75 12 0 69 12 0 83 12 0 33 12 0 32 15 0 32 15 0 51 12 0 54 12 0 43 12 0 32 15 0 32 15 0 32 15 0 77 12 0 79 12 0 86 12 0 69 12 0 83 12 0 32 15 0 32 15 0 32 15 0 32 15 0 32 15 0 32 15 0 32 15 0 179 15 0 
192 15 0 196 15 0 196 15 0 196 15 0 196 15 0 196 15 0 196 15 0 196 15 0 196 15 0 196 15 0 196 15 0 196 15 0 196 15 0 196 15 0 196 15 0 196 15 0 196 15 0 196 15 0 196 15 0 196 15 0 196 15 0 196 15 0 196 15 0 196 15 0 196 15 0 196 15 0 196 15 0 196 15 0 196 15 0 196 15 0 196 15 0 217 15 0 
