10 15
218 15 0 196 15 0 196 15 0 196 15 0 196 15 0 196 15 0 196 15 0 196 15 0 196 15 0 196 15 0 196 15 0 196 15 0 196 15 0 196 15 0 191 15 0 
179 15 0 4 4 0 32 15 0 32 15 0 32 15 0 32 15 0 32 15 0 32 15 0 32 15 0 32 15 0 32 15 0 32 15 0 32 15 0 4 4 0 179 15 0 
179 15 0 32 15 0 32 15 0 32 15 0 200 0 0 200 0 0 200 0 0 200 0 0 200 0 0 200 0 0 32 15 0 32 15 0 32 15 0 32 15 0 179 15 0 
179 15 0 32 15 0 32 15 0 186 0 0 201 15 0 205 15 0 205 15 0 205 15 0 205 15 0 187 15 0 188 0 0 203 0 0 32 15 0 32 15 0 179 15 0 
179 15 0 32 15 0 32 15 0 188 0 0 186 15 0 188 0 0 188 0 0 188 0 0 188 0 0 186 15 0 188 0 0 188 0 0 203 0 0 32 15 0 179 15 0 
179 15 0 32 15 0 188 0 0 188 0 0 186 15 0 188 0 0 188 0 0 188 0 0 188 0 0 186 15 0 188 0 0 203 0 0 32 15 0 32 15 0 179 15 0 
179 15 0 188 0 0 188 0 0 188 0 0 200 15 0 205 15 0 205 15 0 203 15 0 205 15 0 188 15 0 188 0 0 188 0 0 32 15 0 32 15 0 179 15 0 
179 15 0 32 15 0 32 15 0 32 15 0 188 0 0 188 0 0 188 0 0 200 15 0 188 0 0 188 0 0 188 0 0 188 0 0 188 0 0 32 15 0 179 15 0 
179 15 0 4 4 0 32 15 0 32 15 0 32 15 0 32 15 0 32 15 0 32 15 0 32 15 0 32 15 0 32 15 0 32 15 0 32 15 0 4 4 0 179 15 0 
192 15 0 196 15 0 196 15 0 196 15 0 196 15 0 196 15 0 196 15 0 196 15 0 196 15 0 196 15 0 196 15 0 196 15 0 196 15 0 196 15 0 217 15 0 
