10 15
218 15 0 196 15 0 196 15 0 196 15 0 196 15 0 196 15 0 196 15 0 196 15 0 196 15 0 196 15 0 196 15 0 196 15 0 196 15 0 196 15 0 191 15 0 
179 15 0 32 0 0 6 15 0 6 15 0 6 15 0 6 15 0 6 15 0 6 15 0 6 15 0 6 15 0 6 15 0 6 15 0 6 15 0 32 0 0 179 15 0 
179 15 0 32 0 0 3 4 0 3 4 0 3 4 0 3 4 0 3 4 0 3 4 0 3 4 0 3 4 0 3 4 0 3 4 0 3 4 0 32 0 0 179 15 0 
179 15 0 32 0 0 4 15 0 4 15 0 4 15 0 4 15 0 4 15 0 4 15 0 4 15 0 4 15 0 4 15 0 4 15 0 4 15 0 32 0 0 179 15 0 
179 15 0 32 0 0 5 4 0 5 4 0 5 4 0 5 4 0 5 4 0 5 4 0 5 4 0 5 4 0 5 4 0 5 4 0 5 4 0 32 0 0 179 15 0 
179 15 0 32 0 0 6 15 0 6 15 0 6 15 0 6 15 0 6 15 0 6 15 0 6 15 0 6 15 0 6 15 0 6 15 0 6 15 0 32 0 0 179 15 0 
179 15 0 32 0 0 3 4 0 3 4 0 3 4 0 3 4 0 3 4 0 3 4 0 3 4 0 3 4 0 3 4 0 3 4 0 3 4 0 32 0 0 179 15 0 
179 15 0 32 0 0 4 15 0 4 15 0 4 15 0 4 15 0 4 15 0 4 15 0 4 15 0 4 15 0 4 15 0 4 15 0 4 15 0 32 0 0 179 15 0 
179 15 0 32 0 0 5 4 0 5 4 0 5 4 0 5 4 0 5 4 0 5 4 0 5 4 0 5 4 0 5 4 0 5 4 0 5 4 0 32 0 0 179 15 0 
192 15 0 196 15 0 196 15 0 196 15 0 196 15 0 196 15 0 196 15 0 196 15 0 196 15 0 196 15 0 196 15 0 196 15 0 196 15 0 196 15 0 217 15 0 
