10 15
218 15 0 196 15 0 196 15 0 196 15 0 196 15 0 196 15 0 196 15 0 196 15 0 196 15 0 196 15 0 196 15 0 196 15 0 196 15 0 196 15 0 191 15 0 
179 15 0 4 4 0 32 0 0 32 0 0 32 0 0 32 0 0 32 0 0 32 0 0 32 0 0 32 0 0 32 0 0 32 0 0 4 4 0 32 0 0 179 15 0 
179 15 0 32 0 0 32 0 0 32 0 0 32 0 0 32 0 0 32 0 0 32 0 0 32 0 0 32 0 0 32 0 0 32 0 0 32 0 0 32 0 0 179 15 0 
179 15 0 32 0 0 32 0 0 32 0 0 32 0 0 32 0 0 205 15 0 205 15 0 187 15 0 187 0 0 32 0 0 32 0 0 32 0 0 32 0 0 179 15 0 
179 15 0 32 0 0 32 0 0 32 0 0 32 0 0 32 0 0 201 15 0 205 15 0 189 15 0 32 0 0 32 0 0 32 0 0 32 0 0 32 0 0 179 15 0 
179 15 0 32 0 0 32 0 0 32 0 0 32 0 0 32 0 0 211 15 0 205 15 0 205 15 0 32 0 0 32 0 0 32 0 0 32 0 0 32 0 0 179 15 0 
179 15 0 32 0 0 32 0 0 32 0 0 32 0 0 32 0 0 32 0 0 32 0 0 32 0 0 32 0 0 32 0 0 32 0 0 32 0 0 32 0 0 179 15 0 
179 15 0 32 0 0 32 0 0 32 0 0 32 0 0 32 0 0 32 0 0 32 0 0 32 0 0 32 0 0 32 0 0 32 0 0 32 0 0 32 0 0 179 15 0 
179 15 0 4 4 0 32 0 0 32 0 0 32 0 0 32 0 0 32 0 0 32 0 0 32 0 0 32 0 0 32 0 0 32 0 0 32 0 0 4 4 0 179 15 0 
192 15 0 196 15 0 196 15 0 196 15 0 196 15 0 196 15 0 196 15 0 196 15 0 196 15 0 196 15 0 196 15 0 196 15 0 196 15 0 196 15 0 217 15 0 
